xxxxxxxxxx
xxxxxxxx+x
xx+---+x-x
xx-xxx-x-x
xx-xox-x-x
xx-x-x-x-x
xx-x+-+x-x
xx-xxxxx-x
xx+-----+x
xxxxxxxxxx