0000111111
1000000001
1000000201
1111100001
1000000001
1000011111
1000000001
1111111111
